NO	./res/ber_square.xpm
SO	./res/ber_square.xpm
WE	./res/ber_square.xpm
EA	./res/ber_square.xpm
#D	./res/wolf_wood.xpm
#L	./res/wolf_eagle.xpm
C	100,100,120
F	40,40,40

#S 25.5 15.5 ./res/key.xpm 2 2 300.0
#S 2.5 1.5 ./res/nokia.xpm 2 2 300.0

#S 15.5 3.5 ./res/ber_square.xpm 2 2 300.0
#S 17.5 3.5 ./res/ber_square.xpm 2 2 300.0
#S 15.5 7.5 ./res/ber_square.xpm 2 2 300.0
#S 17.5 7.5 ./res/ber_square.xpm 2 2 300.0
#S 13.5 3.5 ./res/ber_square.xpm 2 2 300.0
#S 11.5 3.5 ./res/ber_square.xpm 2 2 300.0
#S 13.5 7.5 ./res/ber_square.xpm 2 2 300.0
#S 11.5 7.5 ./res/ber_square.xpm 2 2 300.0

#A 16.5 4.5 ./res/death_idle.xpm




1111111111
10000000011111111111
10S000000100000000001
100000000100000000001
100000000000000000001
100000000100000000001
100000000100000000001
 11111111100000000001
         100000000001
  11111  100000000001
  10001  100000000001
  10001  100000000001   111
  1000111100000000001  10001
  1000000000000000001  10001
  1000000000000000001111101111
  1000000000000000001000000001
  1101111111111111111000000001
  1000000000000000000000000001
  1000000000000000000000000001
  1000000000000000000000000001
  1000000000000000000000000001
  1111111111111111111111111111
