NO	./res/ber_square.xpm
SO	./res/ber_square.xpm
WE	./res/ber_square.xpm
EA	./res/ber_square.xpm
D	./res/wolf_wood.xpm
L	./res/wolf_eagle.xpm
C	100,100,120
F	40,40,40

S 25.5 15.5 ./res/key.xpm 2 2 300.0
S 2.5 1.5 ./res/nokia.xpm 2 2 300.0

#A 16.5 4.5 ./res/death_idle.xpm






1111111111
10000000011111111111
10S000000100000000001
100000000100000000001
100000000D00000000001
100000000100000000001
100000000100000000001
 11111111100000000001
         100000000001
  11111  100000000001
  10001  100000000001
  10001  100000000001   111
  1000111100000000001  10001
  1000000000000000001  10001
  10000000000000000011111L1111
  1000000000000000001000000001
  11D1111111111111111000000001
  1000000000000000000000000001
  1000000000000000000000000001
  1000000000000000000000000001
  1000000000000000000000000001
  1111111111111111111111111111
