NO	./res/wolf_redwall.xpm
SO	./res/wolf_stonesdirty.xpm
WE	./res/wolf_stones.xpm
EA	./res/wolf_stonescolored.xpm
#D	./res/wolf_wood.xpm
#L	./res/wolf_eagle.xpm
C	20,20,90
F	90,90,10

#S 2.5 1.5 ./res/key.xpm
#S 5.5 1.5 ./res/nokia.xpm 2 2 200.0

111111111111111111111111111111111111111111
100000000001000010000000000000000000000001
100100111111000010000000000000000000000001
100100000000000011111111111111111101111111
1N0111100000000011100000011   110000011
 11   100111000011100000011   110000011
      10011100001111110111    110000011
    1111100100000000000011    110000011
   10000000100000000000011111111000001111111111111111
  100001011111111111000000000000000000000000000000001
  100001000000000000100000000000000000000000000000001
   10000111111111110100111111111111111111111111110001
   100000000000000100010000000000000000000000000010001
    100000000000000111000000000000000000000000000010001
    100000000000000000000000000000000000000000000000001
     1111111111111111111111111111111111111111111111111
