NO	./res/wolf_redwall.xpm
SO	./res/wolf_stonesdirty.xpm
WE	./res/wolf_stones.xpm
EA	./res/wolf_stonescolored.xpm
D	./res/wolf_wood.xpm
L	./res/wolf_eagle.xpm
C	20,20,90
F	90,90,10

S 2.5 1.5 ./res/key.xpm
S 5.5 1.5 ./res/nokia.xpm 16 2 200.0

111111111111111111111111111111111111111111
100D00000001000010000000000000000000000001
100100111111000010000000000000000000000001
1001000000000000111111111111111111D1111111
1N0111100000000011100000011   110000011
 11   100111000011100000011   110000011
      1001110000111111L111    110000011
    1111100100000000000011    110000011
   10000000100000000000011111111000001111111111111111
  100001L11111111111000000000000000000000000000000001
  100001000000000000100000000000000000000000000000001
   1000011111111111L100111111111111111111111111110001
   100000000000000100010000000000000000000000000010001
    100000000000000111000000000000000000000000000010001
    1000000000000000000000000000000000000000000000D0001
     1111111111111111111111111111111111111111111111111
