NO ./res/mc_putchar.xpm
SO ./res/mc_putchar.xpm
WE ./res/mc_putchar.xpm
EA ./res/mc_putchar.xpm
D ./res/mc_putchar.xpm
C 120,120,10
F 120, 20, 120
11111       1111   1111111111
100001     100011110000000001
1000001   1000D00000001111111
10010001 1000100000001
1001100010001100110001
1001 1000011 1001 10001111111
1001  1111   1001  1000000W01
1111         1111   111111111