NO	../res/texture_wall_north
SO	../res/texture_wall_south
WE	../res/texture_wall_west
EA	../res/texture_wall_east

F	220, 100, 0
C	225, 30, 0

111111
101001
101001
101011
100001
111111
