
C 25,30, 250

NO	./res/wall_north.xpm
SO			./res/wall_south.xpm
F	20, 200,2

WE ./res/wall_west.xpm
EA       ./res/wall_east.xpm




  111
111011  11111
10100111100011
10100000000W01
10101111100111
100011  1111
11111



