
F	10,10,10
C	10,10,30
NO	./res/hires/walls/grunge-wall-24.xpm
SO	./res/microscheme.xpm
WE	./res/hires/walls/wall-paint-peeling-plaster.xpm
EA	./res/microscheme.xpm


    
11111
11111
     
  111  
11S011  11111111111111111111111111111111111111111111111111
1000011110001100000000000000000000000000000000000000000001
1000000000000000000000000000000000000000000000000000000001
1001111110011111111111111111111111111111111111111111110001
1001000001010000000000000000000000000000000000000000010001
1101111101010011111111111111111111111100111110000000000001
11011  101010011   1 1 1   11   110000001  1101101001100001111111
1101   101010011 1 11 1111 11 1 110000001   1010101010000000000011
1101   100000011 1 11 111 111   110000001   101010101000001111111
11001   10101011   1 1 11   1 1 11000001   1101010101100001
11100111111111111111111111111111111111111111000000000011101
1  101  1  100000000000000000000000000000000011111111111001
1  101111  100111111111111111111111111111111111111    1111
1  101     10001
1  101  1  10001
1  101     10001
1  101  1  10001
1  101     10001
1  101  11110001
1  111  1  110111
111111111111000111111
100000000000000111111
111111111111111111111
111 11111111111111111
    111111111111111111111
1111111111111111111111111
  
