NO	./res/logo.xpm
SO	./res/brick_wall.xpm
WE	./res/wall_west.xpm
EA	./res/wall_east.xpm

F	20, 200, 80
C	25, 90, 230

1111111111111111111111
1000000000000000000001
1000000000000000000001
1000000000000000000001
1000111111111111110001
1000100000000000010001
1000100000000000010001
1000111111111001110001
1000000000000000000001
1000000000000000000001
1000000111111111110001
10000001         10001
11100111         10N01
11100111         10001
11111111          111