NO	./res/texture_wall_north
SO	./res/texture_wall_south
WE	./res/texture_wall_west
EA	./res/texture_wall_east

F	R,G,B [0-255]
C	R,G,B [0-255]

# Map
111111
1S1001
101001
101011
100001
111111
