NO	./res/microscheme.xpm
SO	./res/microscheme.xpm
WE	./res/microscheme.xpm
EA	./res/microscheme.xpm

F	10,10,10
C	10,10,30



  111
111011  11111111111111111111111111111111111111111111111111
1000011110001100000000000000000000000000000000000000000001
10S0000000000000000000000000000000000000000000000000000001
1000111110011111111111111111111111111111111111111111110001
100011  11110000000000000000000000000000000000000000000001
11111      10000000000000000000000000000000000000000000001
           10001111111111111111111111111111111111111111111
           10001
           10001
           10001
           10001
           11111
