NO	./res/brick_wall.xpm
SO	./res/brick_wall.xpm
WE	./res/brick_wall.xpm
EA	./res/brick_wall.xpm
H	./res/brick_wall.xpm
D	./res/wolf_wood.xpm
L	./res/wolf_eagle.xpm
C	100,100,120
F	40,40,40

S ./res/key.xpm		25.5 14.5	2 2 150.0	key
S ./res/badge.xpm	5.5 2.5	2 2 150.0	badge
S ./res/nokia.xpm	5.5 4.5	2 2 150.0	phone

S ./res/ber_square.xpm	13.5 4.5	2 2 100.0
S ./res/ber_square.xpm	20.5 4.5	2 2 100.0
S ./res/ber_square.xpm	15.5 9.5	2 2 100.0
S ./res/ber_square.xpm	17.5 9.5	2 2 100.0
S ./res/ber_square.xpm	15.5 11.5	2 2 100.0
S ./res/ber_square.xpm	17.5 11.5	2 2 100.0
S ./res/ber_square.xpm	26.5 16.5	2 2 100.0
S ./res/ber_square.xpm	8.5 19.5	2 2 100.0

#Animation [texture_file.xpm] <X Y> <n_frames> <frame_x frame_y>
#							//* <scale_x scale_y> <offset> [tag]
A ./res/death_idle.xpm	1.5 1.5	8	100 100
A ./res/fx.xpm			16.5 6.5	64	100 100


111 111
101 1S1
101 101    1111111111
101 101    1000000001
101 101  111D11111101
1L111D111100000101001
100000000D0000010D001
100000000100000101001
11D111111111D11111111
100000000100000000001
 11111111100000000001
  1000000100000000001
  11D1100100000000001
  1001000100000000001   111
  1001000100000000001  10001
  1011111100000000001  10001
  1000000000000000001  10001
  10000000000000000011111D1111
  1000000000000000001000000001
  11D1111111111111111000000001
  1000000000000000000000000001
  1000000000000000000000000001
  1000000000000000000000000001
  1000000000000000000000000001
  1111111111111111111111111111
