NO	./res/hires/walls/grunge-wall-24.xpm
SO	./res/hires/walls/grunge-wall-white.xpm
WE	./res/hires/walls/wall-texture-gray.xpm
EA	./res/hires/walls/wall-paint-peeling-plaster.xpm

H	./res/brick_wall.xpm
D	./res/hires/doors/door_27.xpm
L	./res/hires/spec/graffiti_queen.xpm

C	100,100,120
F	40,40,40

S ./res/key.xpm		25.5 14.5	2 2 150.0	key
S ./res/badge.xpm	5.5 2.5		2 2 150.0	badge
S ./res/nokia.xpm	5.5 4.5		2 1 150.0	phone
A ./res/tig.xpm		5.5 3.5		12	80 40	2 2 100		tig

A ./res/tig.xpm	13.5 4.5	12	80 40	2 2 100.0	tig
A ./res/tig.xpm	20.5 4.5	12	80 40	2 2 100.0	tig
A ./res/tig.xpm	15.5 9.5	12	80 40	2 2 100.0	tig
A ./res/tig.xpm	17.5 9.5	12	80 40	2 2 100.0	tig
A ./res/tig.xpm	15.5 11.5	12	80 40	2 2 100.0	tig
A ./res/tig.xpm	17.5 11.5	12	80 40	2 2 100.0	tig
A ./res/tig.xpm	26.5 16.5	12	80 40	2 2 100.0	tig
A ./res/tig.xpm	8.5 19.5	12	80 40	2 2 100.0	tig

#Animation [texture_file.xpm] <X Y> <n_frames> <frame_x frame_y>
#							//* <scale_x scale_y> <offset> [tag]
A ./res/death_idle.xpm	1.5 3.5		8	100 100
A ./res/fx.xpm			16.5 5.5	60	100 100


  1111111111111111111
  101S100001000000001
111010111111111111111
101010100001000000001
101010100111D11111101
1L111D111100000101001
100000000D0000010D001
100000000100000101001
11D111111111D11111111
100000000100000000001
 11111111100000000001
  1000000100000000001
  11D1100100000000001
  1001000100000000001111111
  10010001000000000010010001
  10111111000000000010010001
  10000000000000000010010001
  10000000000000000011111D1111
  1000000000000000001000000001
  11D1111111111111111000000001
  1000000000000000000000000001
  1000000000000000000000000001
  1000000000000000000000000001
  1000000000000000000000000001
  1111111111111111111111111111
