NO	./res/brick_wall.xpm
SO	./res/brick_wall.xpm
WE	./res/brick_wall.xpm
EA	./res/brick_wall.xpm
H	./res/brick_wall.xpm
D	./res/wolf_wood.xpm
L	./res/wolf_eagle.xpm
C	100,100,120
F	40,40,40

S 25.5 16.5 ./res/key.xpm 2 2 150.0
S 4.5 3.5 ./res/nokia.xpm 2 2 150.0

S 13.5 4.5 ./res/ber_square.xpm 2 2 100.0
S 20.5 4.5 ./res/ber_square.xpm 2 2 100.0
S 15.5 9.5 ./res/ber_square.xpm 2 2 100.0
S 17.5 9.5 ./res/ber_square.xpm 2 2 100.0
S 15.5 11.5 ./res/ber_square.xpm 2 2 100.0
S 17.5 11.5 ./res/ber_square.xpm 2 2 100.0
S 26.5 16.5 ./res/ber_square.xpm 2 2 100.0
S 8.5 19.5 ./res/ber_square.xpm 2 2 100.0

#A 16.5 4.5 ./res/death_idle.xpm






           1111111111
1111111111 1000000001
100000000111D11111101
10E000000100000101001
100000000D0000010D001
100000000100000101001
11D111111111D11111111
100000000100000000001
 11111111100000000001
  1000000100000000001
  1D11100100000000001
  1000100100000000001
  1000100100000000001   111
  1000111100000000001  10001
  1000000000000000001  10001
  10000000000000000011111L1111
  1000000000000000001000000001
  11D1111111111111111000000001
  1000000000000000000000000001
  1000000000000000000000000001
  1000000000000000000000000001
  1000000000000000000000000001
  1111111111111111111111111111
