NO	./res/ber_round.xpm
SO	./res/brick_wall.xpm
WE	./res/ber_square.xpm
EA	

C	225, 30, 0

111111
101001
101001
101011
100N01
111111
